+----------------------------------+
|                                  |
|       +------------------------+ |
|       |                        | |
|       +------------------------+ |
|                                  |
|                                  |
+-------+ +---------------------+  |
||      | |                     |  |
||      | |                     |  |
||      | |                     |  |
||      | |                     |  |
||      | |                     |  |
+-------+ +---------------------+  |
|                                  |
|                                  |
|                                  |
|                                  |
+----------------------------------+
